****************************************
*                                      *
*   *************** ***************    *
*   *************** ***************    *
*             ***** *****              *
* *********** ***** ***** ************ *
*   ********* ***** ***** **********   *
*                                      *
************* ***** ***** **************
**            ***** *****             **
** ********** *         * *********** **
** ********** *         * *********** **
** ********** ***** ***** *********** **
** ********** ***** ***** *********** **
*                                      *
* ******** ******** ********* ******** *
* ******** ******** ********* ******** *
*                                      *
****************************************
